111111111111
100000000001
101101101101
101101101101
100000000001
1101110111011
1101110111011
100000000001
101110011101
101000000101
101111111101
100000000001
1101110111011
1101110111011
100000000001
101101101101
101101101101
100000000001
111111111111